{
  "name": "Forest Map",
  "enemies": [
    {
      "type": "orc",
      "position": {"x": 300, "y": 300}
    },
    {
      "type": "orc",
      "position": {"x": 500, "y": 400}
    }
  ],
  "tiles": [
    "# # # # # # # # # # # # # # # # # # # # # # # # # # # # # # # # # # # # # # # # # # # # # # # # # # # # # # # # # # # # # # # # # # # # # # # # # # # # # # # #",
    "# . . . . . . . . . . . . . . . . . . . . . . . . . . . . . . . . . . . . . . . . . . . . . . . . . . . . . . . . . . . . . . . . . . . . . . . . . . . . . . #",
    "# . . ~ ~ ~ ~ . . . . . . . . . . . . . . ~ ~ ~ ~ . . . . . . . . . . . . . . . . ~ ~ ~ ~ . . . . ~ ~ ~ ~ . . . . ~ ~ ~ ~ . . . . ~ ~ ~ ~ . . . . ~ ~ ~ ~ . . #",
    "# . . ~ . . ~ . . . . . . . . . . . . . . ~ . . ~ . . . . . . . . . . . . . . . . ~ . . ~ . . . . ~ . . ~ . . . . ~ . . ~ . . . . ~ . . ~ . . . . ~ . . ~ . . #",
    "# . . ~ ~ ~ ~ . . . . . . . . . . . . . . ~ ~ ~ ~ . . . . . . . . . . . . . . . . ~ ~ ~ ~ . . . . ~ ~ ~ ~ . . . . ~ ~ ~ ~ . . . . ~ ~ ~ ~ . . . . ~ ~ ~ ~ . . #",
    "# . . . . . . . . . . . . . . . . . . . . . . . . . . . . . . . . . . . . . . . . . . . . . . . . . . . . . . . . . . . . . . . . . . . . . . . . . . . . . . #",
    "# . . . . . . . . . ^ ^ ^ . . . . . . . . . . . . . . . ^ ^ ^ . . . . ^ ^ ^ . . . . . . . . . . . . . . . . . . . . . . . . . . . . . . . . . . . . . . . . . #",
    "# . . . . . . . . . ^ ^ ^ . . . . . . . . . . . . . . . ^ ^ ^ . . . . ^ ^ ^ . . . . . . . . . . . . . . . . . . . . . . . . . . . . . . . . . . . . . . . . . #",
    "# . . . . . . . . . ^ ^ ^ . . . . . . . . . . . . . . . ^ ^ ^ . . . . ^ ^ ^ . . . . . . . . . . . . . . . . . . . . . . . . . . . . . . . . . . . . . . . . . #",
    "# . . . . . . . . . ^ ^ ^ . . . . . . . . . . . . . . . ^ ^ ^ . . . . ^ ^ ^ . . . . . . . . . . . . . . . . . . . . . . . . . . . . . . . . . . . . . . . . . #",
    "# . . ~ ~ ~ ~ . . . . . . . . . . . . . . ~ ~ ~ ~ . . . . . . . . . . . . . . . . ~ ~ ~ ~ . . . . ~ ~ ~ ~ . . . . ~ ~ ~ ~ . . . . ~ ~ ~ ~ . . . . ~ ~ ~ ~ . . #",
    "# . . ~ . . ~ . . . . . . . . . . . . . . ~ . . ~ . . . . . . . . . . . . . . . . ~ . . ~ . . . . ~ . . ~ . . . . ~ . . ~ . . . . ~ . . ~ . . . . ~ . . ~ . . #",
    "# . . ~ ~ ~ ~ . . . . . . . . . . . . . . ~ ~ ~ ~ . . . . . . . . . . . . . . . . ~ ~ ~ ~ . . . . ~ ~ ~ ~ . . . . ~ ~ ~ ~ . . . . ~ ~ ~ ~ . . . . ~ ~ ~ ~ . . #",
    "# . . . . . . . . . ^ ^ ^ . . . . . . . . . . . . . . . ^ ^ ^ . . . . ^ ^ ^ . . . . . . . . . . . . . . . . . . . . . . . . . . . . . . . . . . . . . . . . . #",
    "# . . . . . . . . . ^ ^ ^ . . . . . . . . . . . . . . . ^ ^ ^ . . . . ^ ^ ^ . . . . . . . . . . . . . . . . . . . . . . . . . . . . . . . . . . . . . . . . . #",
    "# . . . . . . . . . ^ ^ ^ . . . . . . . . . . . . . . . ^ ^ ^ . . . . ^ ^ ^ . . . . . . . . . . . . . . . . . . . . . . . . . . . . . . . . . . . . . . . . . #",
    "# . . . . . . . . . ^ ^ ^ . . . . . . . . . . . . . . . ^ ^ ^ . . . . ^ ^ ^ . . . . . . . . . . . . . . . . . . . . . . . . . . . . . . . . . . . . . . . . . #",
    "# . . ~ ~ ~ ~ . . . . . . . . . . . . . . ~ ~ ~ ~ . . . . . . . . . . . . . . . . ~ ~ ~ ~ . . . . ~ ~ ~ ~ . . . . ~ ~ ~ ~ . . . . ~ ~ ~ ~ . . . . ~ ~ ~ ~ . . #",
    "# . . ~ . . ~ . . . . . . . . . . . . . . ~ . . ~ . . . . . . . . . . . . . . . . ~ . . ~ . . . . ~ . . ~ . . . . ~ . . ~ . . . . ~ . . ~ . . . . ~ . . ~ . . #",
    "# . . ~ ~ ~ ~ . . . . . . . . . . . . . . ~ ~ ~ ~ . . . . . . . . . . . . . . . . ~ ~ ~ ~ . . . . ~ ~ ~ ~ . . . . ~ ~ ~ ~ . . . . ~ ~ ~ ~ . . . . ~ ~ ~ ~ . . #",
    "# . . . . . . . . . ^ ^ ^ . . . . . . . . . . . . . . . ^ ^ ^ . . . . ^ ^ ^ . . . . . . . . . . . . . . . . . . . . . . . . . . . . . . . . . . . . . . . . . #",
    "# . . . . . . . . . ^ ^ ^ . . . . . . . . . . . . . . . ^ ^ ^ . . . . ^ ^ ^ . . . . . . . . . . . . . . . . . . . . . . . . . . . . . . . . . . . . . . . . . #",
    "# . . . . . . . . . ^ ^ ^ . . . . . . . . . . . . . . . ^ ^ ^ . . . . ^ ^ ^ . . . . . . . . . . . . . . . . . . . . . . . . . . . . . . . . . . . . . . . . . #",
    "# . . . . . . . . . ^ ^ ^ . . . . . . . . . . . . . . . ^ ^ ^ . . . . ^ ^ ^ . . . . . . . . . . . . . . . . . . . . . . . . . . . . . . . . . . . . . . . . . #",
    "# . . ~ ~ ~ ~ . . . . . . . . . . . . . . ~ ~ ~ ~ . . . . . . . . . . . . . . . . ~ ~ ~ ~ . . . . ~ ~ ~ ~ . . . . ~ ~ ~ ~ . . . . ~ ~ ~ ~ . . . . ~ ~ ~ ~ . . #",
    "# . . ~ . . ~ . . . . . . . . . . . . . . ~ . . ~ . . . . . . . . . . . . . . . . ~ . . ~ . . . . ~ . . ~ . . . . ~ . . ~ . . . . ~ . . ~ . . . . ~ . . ~ . . #",
    "# . . ~ ~ ~ ~ . . . . . . . . . . . . . . ~ ~ ~ ~ . . . . . . . . . . . . . . . . ~ ~ ~ ~ . . . . ~ ~ ~ ~ . . . . ~ ~ ~ ~ . . . . ~ ~ ~ ~ . . . . ~ ~ ~ ~ . . #",
    "# . . . . . . . . . ^ ^ ^ . . . . . . . . . . . . . . . ^ ^ ^ . . . . ^ ^ ^ . . . . . . . . . . . . . . . . . . . . . . . . . . . . . . . . . . . . . . . . . #",
    "# . . . . . . . . . ^ ^ ^ . . . . . . . . . . . . . . . ^ ^ ^ . . . . ^ ^ ^ . . . . . . . . . . . . . . . . . . . . . . . . . . . . . . . . . . . . . . . . . #",
    "# . . . . . . . . . ^ ^ ^ . . . . . . . . . . . . . . . ^ ^ ^ . . . . ^ ^ ^ . . . . . . . . . . . . . . . . . . . . . . . . . . . . . . . . . . . . . . . . . #",
    "# . . . . . . . . . ^ ^ ^ . . . . . . . . . . . . . . . ^ ^ ^ . . . . ^ ^ ^ . . . . . . . . . . . . . . . . . . . . . . . . . . . . . . . . . . . . . . . . . #",
    "# . . ~ ~ ~ ~ . . . . . . . . . . . . . . ~ ~ ~ ~ . . . . . . . . . . . . . . . . ~ ~ ~ ~ . . . . ~ ~ ~ ~ . . . . ~ ~ ~ ~ . . . . ~ ~ ~ ~ . . . . ~ ~ ~ ~ . . #",
    "# . . ~ . . ~ . . . . . . . . . . . . . . ~ . . ~ . . . . . . . . . . . . . . . . ~ . . ~ . . . . ~ . . ~ . . . . ~ . . ~ . . . . ~ . . ~ . . . . ~ . . ~ . . #",
    "# . . ~ ~ ~ ~ . . . . . . . . . . . . . . ~ ~ ~ ~ . . . . . . . . . . . . . . . . ~ ~ ~ ~ . . . . ~ ~ ~ ~ . . . . ~ ~ ~ ~ . . . . ~ ~ ~ ~ . . . . ~ ~ ~ ~ . . #",
    "# . . . . . . . . . . . . . . . . . . . . . . . . . . . . . . . . . . . . . . . . . . . . . . . . . . . . . . . . . . . . . . . . . . . . . . . . . . . . . . #",
    "# . . . . . . . . . . . . . . . . . . . . . . . . . . . . . . . . . . . . . . . . . . . . . . . . . . . . . . . . . . . . . . . . . . . . . . . . . . . . . . #",
    "# # # # # # # # # # # # # # # # # # # # # # # # # # # # # # # # # # # # # # # # # # # # # # # # # # # # # # # # # # # # # # # # # # # # # # # # # # # # # # # #"
  ]
}