{
  "name": "Forest Map",
  "width": 40,
  "height": 16,
  "tiles": [
    "# # # # # # # # # # # # # # # # # # # # # # # # # # # # # # # # # # # # # # # #",
    "# . . . . . . . . . . . . . . . . . . . . . . . . . . . . . . . . . . . . . . #",
    "# . . ~ ~ ~ ~ . . . . . . . . . . . . . . ~ ~ ~ ~ . . . . . . . . . . . . . . #",
    "# . . ~ . . ~ . . . . . . . . . . . . . . ~ . . ~ . . . . . . . . . . . . . . #",
    "# . . ~ ~ ~ ~ . . . . . . . . . . . . . . ~ ~ ~ ~ . . . . . . . . . . . . . . #",
    "# . . . . . . . . . . . . . . . . . . . . . . . . . . . . . . . . . . . . . . #",
    "# . . . . . . . . . . . . . . . . . . . . . . . . . . . . . . . . . . . . . . #",
    "# . . . . . . . . . . . . . . . . . . . . . . . . . . . . . . . . . . . . . . #",
    "# . . . . . . . . . . . . . . . . . . . . . . . . . . . . . . . . . . . . . . #",
    "# . . . . . . . . . . . . . . . . . . . . . . . . . . . . . . . . . . . . . . #",
    "# . . ~ ~ ~ ~ . . . . . . . . . . . . . . ~ ~ ~ ~ . . . . . . . . . . . . . . #",
    "# . . ~ . . ~ . . . . . . . . . . . . . . ~ . . ~ . . . . . . . . . . . . . . #",
    "# . . ~ ~ ~ ~ . . . . . . . . . . . . . . ~ ~ ~ ~ . . . . . . . . . . . . . . #",
    "# . . . . . . . . . . . . . . . . . . . . . . . . . . . . . . . . . . . . . . #",
    "# . . . . . . . . . . . . . . . . . . . . . . . . . . . . . . . . . . . . . . #",
    "# # # # # # # # # # # # # # # # # # # # # # # # # # # # # # # # # # # # # # # #"
  ]
}